40
40
11 11 11 11 11 11 11 11 11 11 11 11 11 11 11 11 11 11 11 11 11 11 11 11 11 11 11 11 11 11 11 11 11 11 11 11 11 11 11 11 
11 11 11 11 0 2 11 11 11 11 11 11 11 11 11 11 11 11 11 11 11 11 11 11 11 11 11 11 11 11 11 11 11 11 11 11 11 11 11 11 
11 11 2 2 1 2 2 1 11 11 2 2 2 11 11 11 11 11 11 11 11 2 1 2 1 11 11 11 11 11 11 2 1 2 1 2 1 11 11 11 
11 11 2 1 2 2 1 0 2 1 2 2 2 2 11 11 11 11 11 11 2 1 0 2 2 1 11 11 11 11 2 0 2 2 2 2 2 1 11 11 
11 11 2 1 0 2 1 2 1 0 2 2 2 2 11 11 11 11 11 2 2 2 1 2 1 2 1 2 2 2 1 0 2 1 2 0 2 1 11 11 
11 11 2 2 1 2 2 2 2 2 2 2 2 2 11 11 11 11 11 2 1 2 1 2 1 2 2 2 2 2 1 2 0 2 2 2 1 11 11 11 
11 11 11 0 2 11 11 11 11 2 2 2 2 11 11 11 11 11 2 1 0 3 12 2 11 2 1 2 2 2 2 1 2 2 1 2 11 11 11 11 
11 11 11 11 11 11 11 11 11 11 2 2 2 11 11 11 11 11 2 1 12 2 2 11 11 11 11 2 2 2 11 11 11 11 11 11 11 11 11 11 
11 11 11 11 11 11 11 11 11 11 2 2 2 11 11 11 11 11 2 1 2 2 2 11 11 11 11 2 2 2 11 11 11 11 11 11 11 11 11 11 
11 11 11 11 11 11 11 11 11 2 0 2 2 2 1 11 11 11 2 0 11 2 2 2 11 11 2 2 2 2 11 11 11 11 11 11 11 11 11 11 
11 11 11 2 1 2 1 11 11 2 1 2 2 2 2 11 11 2 1 2 1 11 11 2 2 2 2 2 2 2 11 11 11 11 2 1 11 11 11 11 
11 11 2 1 0 2 1 11 11 2 2 2 2 2 2 11 11 2 2 2 1 2 2 2 2 2 2 2 2 11 11 11 11 2 0 2 1 11 11 11 
11 11 2 0 2 0 2 1 2 1 2 2 2 2 2 1 2 1 2 2 2 2 2 2 2 2 2 11 11 11 11 11 11 2 2 2 1 0 11 11 
11 11 2 1 0 2 1 11 11 2 2 2 2 2 0 2 0 2 0 2 1 2 2 2 2 0 2 11 11 2 1 0 2 1 2 2 1 2 11 11 
11 11 11 2 1 2 1 11 11 0 2 2 2 2 2 2 2 2 2 1 2 2 2 2 2 2 2 2 11 2 11 11 11 2 1 2 1 11 11 11 
11 11 11 11 2 11 11 11 11 2 2 2 2 2 2 2 2 2 2 2 2 2 2 2 11 11 11 2 11 2 11 11 11 11 11 2 2 11 11 11 
11 11 11 11 2 11 11 11 11 2 2 2 2 2 2 2 2 2 2 2 2 2 2 2 11 11 11 2 11 2 11 11 11 11 11 2 1 11 11 11 
11 11 11 11 0 11 11 11 11 11 11 2 1 2 2 2 2 2 1 2 1 2 1 11 11 2 0 2 11 2 11 11 11 11 11 0 2 11 11 11 
11 11 2 0 2 11 11 11 11 11 2 0 11 11 11 11 11 2 1 0 2 2 2 11 11 0 11 11 11 2 2 11 11 11 11 2 1 11 11 11 
11 11 2 11 11 11 11 11 11 2 1 11 11 11 11 11 11 2 2 2 1 0 2 11 11 0 2 2 11 11 2 11 11 11 11 11 2 11 11 11 
11 11 0 2 2 2 2 0 2 2 2 11 11 11 2 1 0 2 1 2 2 2 2 11 11 2 11 2 0 2 1 11 11 11 11 11 2 11 11 11 
11 11 11 11 11 11 11 11 11 2 1 2 11 11 11 11 11 2 0 2 2 1 0 11 11 2 11 11 11 11 11 11 11 11 11 11 2 11 11 11 
11 11 11 11 11 11 11 11 11 11 0 2 11 11 11 11 11 0 2 1 2 1 2 11 11 2 1 0 2 0 2 11 11 11 11 11 0 11 11 11 
11 11 11 11 11 11 11 11 11 11 11 2 11 11 11 11 11 11 11 11 11 11 11 11 11 11 11 11 11 11 2 11 11 11 11 11 2 11 11 11 
11 11 11 11 11 11 11 11 11 11 11 0 11 11 11 11 11 11 11 2 1 11 11 11 11 11 11 11 11 11 2 11 11 11 11 11 2 11 11 11 
11 11 11 11 11 11 11 11 11 11 11 2 2 11 11 11 11 11 2 1 2 11 11 11 11 11 11 0 2 1 2 11 11 11 11 11 2 0 2 11 
11 11 11 2 0 11 11 11 11 2 2 2 2 2 11 11 11 11 2 2 2 0 11 11 11 11 2 1 2 2 1 11 11 11 11 11 0 2 0 11 
11 11 2 1 2 2 2 11 2 1 0 2 2 2 2 11 11 11 2 0 2 2 11 11 11 2 2 0 2 1 2 0 2 0 11 11 11 0 11 11 
11 11 2 2 2 2 0 11 2 1 2 2 2 2 2 11 11 2 2 2 0 2 11 11 11 2 1 2 2 0 2 1 2 2 2 11 11 11 11 11 
11 11 11 2 1 2 1 11 11 11 2 2 2 0 2 1 2 0 2 1 2 1 11 11 11 0 2 1 2 2 11 11 11 0 2 2 2 2 2 11 
11 11 11 0 2 2 2 11 11 11 11 2 2 11 11 11 11 2 11 11 11 2 1 2 1 2 0 2 1 11 11 11 11 2 2 2 2 2 2 11 
11 11 11 2 2 11 11 11 11 11 11 11 11 11 11 11 11 11 11 11 11 11 11 11 11 11 11 11 11 11 11 11 11 11 11 2 2 2 2 11 
11 11 11 2 1 11 11 11 11 11 11 11 11 11 11 11 11 2 11 11 11 2 11 11 11 11 11 11 11 11 11 11 11 11 11 2 2 2 2 11 
11 11 11 2 1 11 11 11 11 11 11 11 11 11 2 1 2 0 11 11 11 2 1 2 1 0 2 11 11 11 11 11 11 11 2 2 2 2 2 11 
11 11 2 0 2 11 11 11 11 11 11 0 2 1 2 11 11 11 11 11 11 2 0 2 1 2 2 2 11 11 11 11 11 11 2 2 2 2 2 11 
11 11 2 2 1 11 11 11 11 11 11 2 11 11 11 11 11 11 11 11 2 2 2 0 2 0 2 0 2 11 11 11 11 11 2 2 2 2 2 11 
11 11 2 1 2 2 11 11 11 11 11 0 11 11 11 11 11 11 11 11 2 1 2 1 2 2 2 2 1 11 11 11 11 11 11 2 2 2 11 11 
11 11 11 2 0 2 1 2 1 2 2 2 11 11 11 11 11 11 11 11 11 0 2 1 0 2 2 2 11 11 11 11 11 11 11 2 1 2 11 11 
11 11 11 11 2 2 11 11 11 11 11 11 11 11 11 11 11 11 11 11 11 11 11 11 11 2 1 11 11 11 11 11 11 11 11 11 2 11 11 11 
11 11 11 11 11 11 11 11 11 11 11 11 11 11 11 11 11 11 11 11 11 11 11 11 11 11 11 11 11 11 11 11 11 11 11 11 11 11 11 11 
